Dimensions{widht,height}:
24,13

BackGround_F:
57,57,57,57,57,57,57,57,57,57,57,57,57,57,57,57,57,57,57,57,57,57,57,57,
57,57,57,57,57,57,57,57,57,57,57,57,57,57,57,57,57,57,57,57,57,57,57,57,
57,57,57,57,57,57,57,57,57,57,57,201,201,57,57,57,57,57,57,57,57,57,57,57,
57,57,57,57,57,57,57,57,57,57,57,203,203,57,57,57,57,57,57,57,57,57,57,57,
57,57,57,57,57,57,57,57,57,57,57,203,203,57,57,57,57,57,57,57,57,57,57,57,
57,57,57,57,57,57,57,57,57,57,57,201,201,57,57,57,57,57,57,57,57,57,57,57,
57,57,57,57,57,57,201,57,57,57,57,201,201,57,57,57,57,201,57,57,57,57,57,57,
57,57,57,57,57,57,201,201,57,57,57,57,57,57,57,57,201,201,57,57,57,57,57,57,
57,57,57,57,201,201,201,201,201,57,57,57,57,57,57,201,201,201,201,201,57,57,57,57,
57,57,57,57,57,57,57,57,57,57,57,57,57,57,57,57,57,57,57,57,57,57,57,57,
57,57,57,57,57,57,57,57,57,57,57,57,57,57,57,57,57,57,57,57,57,57,57,57,
57,57,57,57,57,57,57,57,57,57,57,57,57,57,57,57,57,57,57,57,57,57,57,57,
57,57,57,57,57,57,57,57,57,57,57,57,57,57,57,57,57,57,57,57,57,57,57,57

BackGround_S:
0,0,3,3,0,3,3,0,3,3,0,3,3,0,3,3,0,3,3,0,3,3,3,2,
0,201,182,0,0,0,0,0,0,203,0,124,125,0,203,0,0,0,0,0,0,184,201,2,
0,201,182,182,201,0,0,0,201,0,0,124,125,0,0,0,0,0,0,201,184,182,201,2,
0,201,201,182,182,182,201,0,0,203,0,124,125,0,203,203,0,203,184,184,182,201,201,0,
0,0,0,0,201,182,182,0,203,0,0,148,149,203,0,0,0,182,184,0,0,203,0,0,
0,0,203,34,0,0,182,182,0,0,201,172,173,0,0,201,184,184,203,0,203,0,0,0,
0,0,0,203,203,182,182,182,201,0,203,196,197,0,203,0,184,182,182,203,0,0,0,0,
0,0,203,0,182,182,0,182,182,182,0,0,203,0,184,184,182,0,182,182,0,0,0,0,
0,203,0,182,182,0,0,0,182,182,201,0,0,0,184,182,0,0,0,182,182,0,0,0,
0,203,182,182,0,0,0,201,0,182,182,182,184,184,182,0,201,0,34,0,182,182,0,0,
0,182,182,0,201,0,0,0,0,0,182,182,184,184,0,0,0,201,0,0,0,182,182,0,
182,182,0,0,0,0,0,0,0,0,0,182,184,0,0,0,0,0,0,201,0,0,182,182,
3,0,0,0,0,0,0,0,0,0,0,182,184,0,0,0,0,0,0,0,0,0,0,0

Concrete:
2,3,0,0,0,0,0,0,0,0,0,0,0,0,0,0,0,0,0,0,0,0,0,0,
19,0,0,0,0,0,0,0,0,0,0,0,0,0,0,0,0,0,0,0,0,0,0,0,
43,0,0,0,0,0,0,0,0,0,0,0,0,0,0,0,0,0,0,0,0,0,0,0,
67,0,0,0,0,0,0,0,0,0,0,0,0,0,0,0,0,0,0,0,0,0,0,2,
2,3,3,4,0,0,0,0,0,0,0,0,0,0,0,0,0,0,0,0,0,0,0,2,
4,0,0,0,2,4,0,0,0,0,0,0,0,0,0,0,0,0,0,0,0,0,0,2,
4,0,0,0,0,0,0,14,0,0,0,0,0,0,0,0,14,0,0,0,0,0,0,2,
4,0,0,0,0,0,0,0,0,14,0,0,0,0,14,0,0,0,0,0,0,0,0,2,
4,0,0,0,0,0,0,0,0,0,0,0,0,0,0,0,0,0,14,0,0,0,0,2,
4,0,0,0,0,0,0,0,0,0,0,2,4,0,0,0,0,0,0,14,0,0,0,0,
4,0,0,0,0,0,0,0,0,0,0,0,0,0,0,0,0,0,0,0,0,0,0,0,
4,0,0,0,0,0,0,0,0,0,0,0,0,0,0,0,0,0,0,0,0,0,0,0,
0,3,3,3,3,3,3,3,3,3,3,3,3,3,3,3,3,3,2,3,3,3,3,4

Foreground:
0,0,0,0,121,0,0,122,0,0,123,0,0,123,0,0,122,0,0,121,0,0,0,0,
0,0,0,0,121,0,0,122,0,0,123,0,0,123,0,0,122,0,0,121,0,0,0,0,
0,0,0,0,145,0,0,146,0,0,147,0,0,147,0,0,146,0,0,145,0,0,0,0,
0,0,0,0,0,0,0,0,0,0,0,0,0,0,0,0,0,0,0,0,0,0,0,0,
0,0,0,0,0,0,0,0,0,0,0,0,0,0,0,0,0,0,0,0,0,0,0,0,
0,0,0,0,0,0,0,0,0,0,0,0,0,0,0,0,0,0,0,0,0,0,0,0,
0,0,0,0,0,0,0,0,0,0,0,0,0,0,0,0,0,0,0,0,0,0,0,0,
0,0,0,0,0,0,0,0,0,0,0,0,0,0,0,0,0,0,0,0,0,0,0,0,
0,0,0,0,0,0,0,0,0,0,0,0,0,0,0,0,0,0,0,0,0,0,0,0,
0,0,0,0,0,0,0,0,0,0,0,0,0,0,0,0,0,0,0,0,0,0,0,0,
0,0,0,0,0,0,0,0,0,0,0,0,0,0,0,0,0,0,0,0,0,0,0,0,
0,0,0,0,0,0,0,0,0,0,0,0,0,0,0,0,0,0,0,0,0,0,0,0,
0,0,0,0,0,0,0,0,0,0,0,0,0,0,0,0,0,0,0,0,0,0,0,0

Position:
0,0,0,0,0,0,0,0,0,0,0,0,0,0,0,0,0,0,0,0,0,0,0,0,
0,0,0,0,0,0,0,0,0,0,0,0,0,0,0,0,0,0,0,0,0,0,0,0,
0,0,0,0,0,0,0,0,0,0,0,0,0,0,0,0,0,0,0,0,0,0,0,0,
0,169,0,0,0,0,0,0,0,0,0,0,0,0,0,0,0,0,0,0,0,0,0,171,
0,0,0,0,0,0,0,0,0,0,0,0,0,0,0,0,0,0,0,0,0,0,0,171,
171,0,0,0,0,0,0,0,0,0,0,0,0,0,0,0,0,0,0,0,0,0,0,171,
171,0,0,0,0,0,0,0,0,0,0,0,0,0,0,0,0,0,0,0,0,0,0,171,
171,0,0,0,0,0,0,0,0,0,0,0,0,0,0,0,0,0,0,0,0,0,0,171,
171,0,0,0,0,0,0,0,0,0,0,0,0,0,0,0,0,0,0,0,0,0,0,171,
171,0,0,0,0,0,0,0,0,0,0,0,0,0,0,0,0,0,0,0,0,0,0,193,
0,0,0,0,0,0,0,0,0,0,0,0,0,0,0,0,0,0,0,0,0,0,0,193,
0,0,0,170,0,170,0,170,0,170,0,170,0,170,0,170,0,170,0,0,0,0,0,193,
0,0,0,0,0,0,0,0,0,0,0,0,0,0,0,0,0,0,0,0,0,0,0,0