Dimensions{widht,height}:
24,13

Background_F:
57,57,57,57,57,57,57,57,57,57,57,57,57,57,57,57,57,57,57,57,57,57,57,57,
57,57,57,57,57,57,57,57,57,57,57,57,57,57,57,57,57,57,57,57,57,57,57,57,
57,57,57,57,57,57,57,57,57,57,57,57,57,57,57,57,57,57,57,57,57,57,57,57,
57,57,57,57,57,57,57,57,57,57,57,57,57,57,57,57,57,57,57,57,57,57,57,57,
57,57,57,57,57,57,57,57,57,57,57,57,57,57,57,57,57,57,57,57,57,57,57,57,
57,57,57,57,57,57,57,57,57,57,57,57,57,57,57,57,57,57,57,57,57,57,57,57,
57,57,57,57,57,57,57,57,57,57,57,57,57,57,57,57,57,57,57,57,57,57,57,57,
57,57,57,57,57,57,57,57,57,57,57,57,57,57,57,57,57,57,57,57,57,57,57,57,
57,57,57,57,57,57,57,57,57,57,57,57,57,57,57,57,57,57,57,57,57,57,57,57,
57,57,57,57,57,57,57,57,57,57,57,57,57,57,57,57,57,57,57,57,57,57,57,57,
57,57,57,57,57,57,57,57,57,57,57,57,57,57,57,57,57,57,57,57,57,57,57,57,
57,57,57,57,57,57,57,57,57,57,57,57,57,57,57,57,57,57,57,57,57,57,57,57,
57,57,57,57,57,57,57,57,57,57,57,57,57,57,57,57,57,57,57,57,57,57,57,57

Background_S:
0,0,0,0,0,0,3,3,3,3,3,3,0,0,0,0,0,0,0,0,0,0,0,0,
0,0,0,0,49,53,0,0,0,0,0,0,0,0,0,0,49,53,0,0,0,0,0,0,
3,0,0,0,49,53,0,0,0,0,0,0,0,0,0,0,49,0,0,0,0,0,0,0,
0,0,0,0,49,53,29,0,0,49,53,0,0,0,0,0,49,53,0,0,0,0,0,0,
3,0,0,0,49,53,0,0,29,49,53,0,0,0,0,0,49,0,0,0,0,0,0,0,
0,0,0,0,49,53,0,0,0,49,53,29,29,0,0,0,49,53,0,0,0,0,0,2,
3,0,0,0,49,53,25,0,0,49,53,0,0,0,0,0,49,0,0,0,0,0,0,0,
0,0,0,0,49,53,0,0,0,49,53,0,0,0,0,0,49,53,0,0,0,0,0,0,
3,0,0,0,0,0,0,0,29,49,53,0,4,3,3,2,49,53,0,0,0,0,0,0,
19,0,0,0,0,0,14,0,0,49,53,0,0,0,0,0,49,53,0,0,0,0,0,29,
43,0,0,0,4,0,0,0,0,49,53,0,0,0,0,0,49,53,0,0,0,3,3,0,
67,0,0,2,4,0,0,0,0,49,53,0,0,0,0,0,0,0,0,0,3,4,0,0,
0,3,3,3,3,3,3,3,4,0,0,2,3,3,3,3,3,3,3,3,4,0,0,0

Concrete:
0,0,0,0,0,0,3,3,3,3,3,3,0,0,0,0,0,0,0,0,0,0,0,0,
0,0,0,0,49,53,0,0,0,0,0,0,0,0,0,0,49,0,0,0,0,0,0,0,
3,0,0,0,49,53,0,0,0,0,0,0,0,0,0,0,49,0,0,0,0,0,0,0,
0,0,0,0,49,53,29,0,0,49,53,0,0,0,0,0,49,0,0,0,0,0,0,0,
3,0,0,0,49,53,0,0,29,49,53,0,0,0,0,0,49,0,0,0,0,0,0,0,
0,0,0,0,49,53,0,0,0,49,53,29,29,0,0,0,49,0,0,0,0,0,0,2,
3,0,0,0,49,53,25,0,0,49,53,0,0,0,0,0,49,0,0,0,0,0,0,0,
0,0,0,0,49,53,0,0,0,49,53,0,0,0,0,0,49,0,0,0,0,0,0,0,
3,0,0,0,0,0,0,0,29,49,53,0,4,3,3,2,49,53,0,0,0,0,0,0,
19,0,0,0,0,0,14,0,0,49,53,0,0,0,0,0,49,53,0,0,0,0,0,29,
43,0,0,0,4,0,0,0,0,49,53,0,0,0,0,0,49,53,0,0,0,3,3,0,
67,0,0,2,4,0,0,0,0,49,53,0,0,0,0,0,0,0,0,0,3,4,0,0,
0,3,3,3,3,3,3,3,4,0,0,2,3,3,3,3,3,3,3,3,4,0,0,0

Foreground":
0,0,123,0,0,0,0,121,0,0,0,0,0,123,0,0,0,0,0,0,123,0,0,0,
0,0,147,0,0,0,0,145,0,0,0,0,0,147,0,0,0,0,0,0,147,0,0,0,
0,0,0,0,0,0,0,0,0,0,0,0,0,0,0,0,0,0,0,0,0,0,0,0,
0,0,0,0,0,0,0,0,0,0,0,0,0,0,0,0,0,0,0,0,0,0,0,0,
0,0,0,0,0,0,0,0,0,0,0,0,0,0,0,0,0,0,0,0,0,0,0,0,
0,0,0,0,0,0,0,0,0,0,0,0,0,0,0,0,0,0,0,0,0,0,0,0,
0,0,0,0,0,0,0,0,0,0,0,0,0,0,0,0,0,0,0,0,0,0,0,0,
0,0,0,0,0,0,0,0,0,0,0,0,0,0,0,0,0,0,0,0,0,0,0,0,
0,0,0,0,0,0,0,0,0,0,0,0,0,0,0,0,0,0,0,0,0,0,0,0,
0,0,0,0,0,0,0,0,0,0,0,0,0,0,0,0,0,0,0,0,0,0,0,0,
0,0,0,0,0,0,0,0,0,0,0,0,0,0,0,0,0,0,0,0,0,0,0,0,
0,0,0,0,0,0,0,0,0,0,0,0,0,0,0,0,0,0,0,0,0,0,0,0,
0,0,0,0,0,0,0,0,0,0,0,0,0,0,0,0,0,0,0,0,3,0,0,0

Position:
0,0,0,0,0,0,0,0,0,0,0,0,0,0,0,0,0,0,0,0,0,0,0,0,
0,0,0,0,0,0,0,0,0,0,0,0,0,0,0,0,171,0,0,0,0,0,0,0,
171,0,0,0,0,0,0,0,0,0,0,0,0,0,0,0,0,0,0,0,0,0,0,0,
0,0,0,0,0,0,0,0,0,0,0,0,0,0,0,0,171,0,0,0,0,0,0,0,
171,0,0,0,0,0,0,0,0,0,0,0,0,0,0,0,0,0,0,0,0,0,0,0,
0,0,0,0,0,0,0,0,0,0,0,0,0,0,0,0,171,0,0,0,0,0,0,0,
171,0,0,0,0,0,0,0,0,0,0,0,0,0,0,0,0,0,0,0,0,0,0,193,
0,0,0,0,0,0,0,0,0,0,0,0,170,0,0,0,171,0,0,0,0,0,0,193,
171,0,0,0,0,0,0,0,0,0,0,0,0,0,0,0,0,0,0,0,0,0,0,193,
0,0,0,0,0,0,0,0,0,0,0,0,0,0,0,0,0,0,0,0,0,0,0,0,
0,0,0,0,0,0,0,0,0,0,0,0,0,0,0,0,0,0,0,0,0,0,0,0,
0,169,0,0,0,194,194,194,194,0,0,0,0,0,0,170,0,0,0,0,0,0,0,0,
0,0,0,0,0,0,0,0,0,0,0,0,0,0,0,0,0,0,0,0,0,0,0,0