Dimensions{widht,height}:
24,13

Background_F:
57,57,57,57,57,57,57,57,57,57,57,57,57,57,57,57,57,57,57,57,57,57,57,57,
57,57,57,57,57,57,57,57,57,57,57,57,57,57,57,57,57,57,57,57,57,57,57,57,
57,57,57,57,57,57,57,57,57,57,57,57,57,57,57,57,57,57,57,57,57,57,57,57,
57,57,57,57,57,57,57,57,57,57,57,57,57,57,57,57,57,57,57,57,57,57,57,57,
57,57,57,57,57,57,57,57,57,57,57,57,57,57,57,57,57,57,57,57,57,57,57,57,
57,57,57,57,57,57,57,57,57,57,57,57,57,57,57,57,57,57,57,57,57,57,57,57,
57,57,57,57,57,57,57,57,57,57,57,57,57,57,57,57,57,57,57,57,57,57,57,57,
57,57,57,57,57,57,57,57,57,57,57,57,57,57,57,57,57,57,57,57,57,57,57,57,
57,57,57,57,57,57,57,57,57,57,57,57,57,57,57,57,57,57,57,57,57,57,57,57,
57,57,57,57,57,57,57,57,57,57,57,57,57,57,57,57,57,57,57,57,57,57,57,57,
57,57,57,57,57,57,57,57,57,57,57,57,57,57,57,57,57,57,57,57,57,57,9,57,
57,57,57,57,57,57,57,57,57,57,57,57,57,57,57,57,57,57,57,57,57,9,57,57,
57,57,57,57,57,57,57,57,57,57,57,57,57,57,57,57,57,57,57,57,9,57,57,57

Background_S:
2,3,3,3,3,0,0,0,0,0,3,3,3,3,3,3,3,3,3,3,3,3,3,4,
4,0,0,31,0,0,0,0,201,0,0,201,0,0,203,0,201,0,0,0,201,0,0,0,
4,0,0,0,9,0,0,0,0,203,201,0,0,0,0,0,201,0,0,0,0,0,201,0,
4,0,0,0,201,31,49,53,0,0,0,0,0,0,0,0,0,0,0,0,0,0,0,0,
4,0,0,0,0,201,49,34,0,0,0,124,125,201,22,23,24,0,0,0,203,0,0,0,
0,0,0,0,0,0,49,51,53,201,0,148,149,0,46,47,48,0,0,0,0,0,0,0,
0,0,0,0,203,0,0,51,53,0,0,172,173,0,70,71,72,0,0,0,0,0,201,0,
0,201,0,0,0,0,0,51,0,0,203,196,197,203,94,95,96,0,0,0,201,0,0,0,
0,0,0,0,201,0,0,51,0,0,201,0,0,0,118,95,120,0,0,203,0,0,0,0,
0,0,0,0,0,0,0,82,0,0,0,0,0,201,0,119,0,0,0,0,0,0,0,0,
25,0,203,0,0,203,0,0,203,0,0,0,0,0,0,0,0,203,0,203,0,3,32,0,
25,0,0,0,0,0,201,0,0,0,0,32,0,0,34,0,0,0,0,0,0,32,0,0,
25,0,0,0,0,0,0,0,0,0,0,0,0,0,0,34,0,0,0,0,32,0,0,0

Concrete:
0,0,0,0,0,0,2,3,3,3,0,0,0,0,0,0,0,0,0,0,0,0,0,0,
0,0,0,0,4,0,0,0,0,0,0,0,0,0,0,0,0,0,0,0,0,0,0,25,
0,0,0,0,0,3,3,3,0,0,0,0,0,0,0,0,0,0,0,0,0,0,0,2,
0,0,0,0,0,0,0,0,3,3,3,3,3,3,3,3,3,3,3,4,0,0,0,2,
0,0,0,0,0,0,0,0,49,0,0,0,0,0,0,0,0,0,0,0,0,14,0,2,
4,0,0,0,0,0,0,0,0,0,0,0,0,0,0,0,0,0,0,0,0,0,0,2,
19,0,0,0,0,0,49,0,0,0,0,0,0,0,0,0,0,2,3,3,4,0,0,2,
43,0,0,0,0,0,49,0,49,0,0,0,0,0,0,0,0,0,0,0,0,0,2,2,
67,0,0,0,0,0,49,0,53,0,0,0,0,0,0,0,0,0,0,0,0,0,0,2,
2,3,3,4,0,0,49,0,49,0,0,0,0,0,0,0,0,2,2,2,2,4,2,2,
0,0,0,0,0,0,49,53,0,0,0,2,3,3,3,4,0,0,0,0,0,0,0,0,
25,0,0,0,0,0,0,0,0,0,2,0,0,0,0,4,0,0,0,0,3,0,0,0,
0,25,25,25,25,2,3,3,3,3,3,0,0,0,0,0,4,4,4,4,0,0,0,0

Foreground:
0,122,121,123,0,0,0,0,0,0,0,0,0,0,0,0,0,0,0,0,0,0,0,0,
0,122,121,123,0,0,0,0,0,0,0,0,0,0,0,0,0,0,0,0,0,0,0,0,
0,122,121,123,0,0,0,0,0,0,0,0,0,0,0,0,0,0,0,0,0,0,0,0,
0,122,121,123,0,0,0,0,0,0,0,0,0,0,0,0,0,0,0,0,0,0,0,0,
0,122,121,123,0,0,0,0,0,0,0,0,0,0,0,0,0,0,0,0,0,0,0,0,
0,122,121,123,0,0,0,0,0,0,0,0,0,0,0,0,0,0,0,0,0,0,0,0,
0,146,145,147,0,0,0,0,0,0,0,0,0,0,0,0,0,0,0,0,0,0,0,0,
0,0,0,0,0,0,0,0,0,0,0,0,0,0,0,0,0,0,0,0,0,0,0,0,
0,0,0,0,0,0,0,0,0,0,0,0,0,0,0,0,0,0,0,0,0,0,0,0,
0,0,0,0,0,0,0,0,0,0,0,0,0,0,0,0,0,0,0,0,0,0,0,0,
0,0,0,0,0,0,0,0,0,0,0,0,0,0,0,0,0,0,0,0,0,0,0,0,
0,0,0,0,0,0,0,0,0,0,0,0,0,0,0,0,0,0,0,0,0,0,0,0,
0,0,0,0,0,0,0,0,0,0,0,0,0,0,0,0,0,0,0,0,0,0,0,0

Positions:
0,0,0,0,0,193,0,0,0,0,0,0,0,0,0,0,0,0,0,0,0,0,0,0,
0,0,0,0,171,0,0,0,0,0,0,0,0,0,0,0,0,0,0,0,0,0,0,0,
0,0,0,0,0,0,0,0,0,0,0,0,170,0,0,0,0,0,0,0,0,0,0,171,
0,0,0,0,0,0,0,0,0,0,0,0,0,0,0,0,0,0,0,0,0,0,0,0,
0,0,0,0,0,0,0,0,171,0,0,0,0,0,0,0,0,0,0,0,0,0,0,171,
0,0,0,0,0,0,0,0,0,0,0,0,0,0,0,0,0,170,0,0,0,0,0,171,
0,0,0,0,0,0,0,0,0,0,0,0,0,0,0,0,0,0,0,0,0,0,0,171,
0,0,0,0,0,0,0,0,171,0,0,0,0,0,0,0,0,0,0,0,0,0,0,0,
0,169,0,0,0,0,0,0,0,0,0,0,0,0,0,0,0,0,0,0,0,0,0,171,
0,0,0,0,0,0,0,0,171,0,0,0,0,0,170,0,0,0,0,0,0,0,0,0,
0,0,0,0,0,0,0,0,0,0,0,0,0,0,0,0,0,0,0,0,0,0,0,0,
0,194,194,194,194,0,0,0,0,0,0,0,0,0,0,0,194,194,194,194,0,0,0,0,
0,0,0,0,0,0,0,0,0,0,0,0,0,0,0,0,0,0,0,0,0,0,0,0