Dimensions{widht,height}:
24,13

BackGround_F:
57,57,57,57,57,57,57,57,57,57,57,57,57,57,57,57,57,57,57,57,57,57,57,57,
57,57,57,57,57,57,57,57,57,57,57,57,57,203,57,150,151,57,57,57,57,57,57,57,
57,57,57,201,57,57,57,57,57,57,57,57,57,57,57,174,175,57,57,57,57,57,57,57,
57,57,57,57,57,57,57,57,57,57,57,57,57,57,57,198,199,57,57,57,57,57,57,57,
57,57,57,57,57,57,57,57,57,57,57,57,57,57,57,57,57,57,57,57,203,57,57,57,
57,57,57,57,57,57,57,57,57,57,57,57,57,57,57,57,57,57,57,57,57,57,57,57,
57,57,57,57,57,57,57,57,57,57,57,57,57,57,57,57,57,57,57,57,57,57,57,57,
57,57,57,57,57,57,57,57,57,57,57,57,57,57,201,57,57,57,57,57,57,57,57,57,
57,57,57,57,201,57,57,57,57,57,57,57,57,57,57,57,57,57,57,57,57,57,57,57,
57,57,57,57,57,57,57,57,57,57,57,57,57,57,57,57,57,57,57,57,57,57,57,57,
57,57,57,57,57,57,57,57,57,57,57,57,57,57,57,57,57,57,57,57,57,57,57,57,
57,57,57,57,57,57,57,57,57,57,57,57,57,57,57,57,57,57,57,57,57,57,57,57,
57,57,57,57,57,57,57,57,57,57,57,57,57,57,57,57,57,57,57,57,57,57,57,57

BackGround_S:
53,49,0,0,0,0,0,0,0,0,0,59,55,0,0,0,0,99,99,99,99,0,53,49,
53,49,0,0,0,0,0,0,0,0,0,59,55,0,0,0,0,124,125,0,0,0,53,49,
53,49,0,0,0,0,0,0,0,0,0,59,55,0,0,0,0,148,149,0,0,0,53,49,
53,0,0,0,0,123,0,123,0,0,0,59,55,0,0,0,0,172,173,0,0,0,53,49,
53,49,0,0,0,147,0,147,0,0,0,59,55,0,0,0,0,196,197,0,0,0,53,49,
53,49,0,0,0,0,0,0,0,0,22,59,55,24,0,0,0,0,0,0,0,0,0,49,
53,49,0,0,0,0,0,0,0,0,0,59,55,0,0,0,0,0,0,0,0,0,53,49,
53,49,0,0,0,0,0,0,0,0,0,59,55,0,0,0,123,0,147,0,0,0,53,49,
53,49,0,0,0,0,0,0,0,0,0,59,55,0,0,0,147,0,0,0,0,0,53,49,
53,0,0,0,0,0,0,0,0,0,22,59,55,24,0,0,0,0,0,0,0,0,53,49,
53,49,0,0,0,0,0,0,0,0,0,59,55,0,0,0,0,0,0,0,0,0,53,49,
53,49,0,0,0,0,0,0,0,0,0,59,55,0,0,0,0,0,0,0,0,0,53,49,
53,49,0,0,0,0,0,0,0,0,0,59,55,0,0,0,0,0,0,0,0,0,53,49

Concrete:
0,0,53,99,99,0,0,0,99,99,99,99,99,99,99,99,99,0,0,0,0,49,0,0,
0,0,53,0,0,0,0,0,0,0,0,0,0,0,0,0,0,0,0,0,0,49,0,0,
0,0,53,0,0,2,3,4,0,0,0,0,0,0,0,0,0,0,0,0,0,49,0,0,
0,49,53,0,0,0,0,0,0,0,0,0,0,0,0,0,0,0,0,0,0,49,0,0,
0,0,53,0,0,0,0,0,0,0,2,3,3,4,0,0,0,0,0,0,0,49,0,0,
0,0,53,0,0,0,0,0,0,0,0,0,0,0,0,0,0,0,0,0,0,49,53,0,
0,0,53,0,0,2,3,4,0,0,0,0,0,0,0,0,2,3,4,0,0,49,0,0,
0,0,53,0,0,0,0,0,0,0,0,0,0,0,0,0,0,0,0,0,0,49,0,0,
0,0,53,0,0,0,0,0,0,0,2,3,3,4,0,0,0,0,0,0,0,49,0,0,
0,49,53,0,0,0,0,0,0,0,0,0,0,0,0,0,0,0,0,0,0,49,0,0,
0,0,53,0,0,0,0,0,0,0,0,0,0,0,0,0,2,3,4,0,0,49,0,0,
0,0,53,0,0,0,0,0,0,0,0,0,0,0,0,0,0,0,0,0,0,49,0,0,
0,0,53,3,3,3,3,3,3,3,3,3,3,3,3,3,3,3,44,45,46,49,0,0

Foregound:
0,0,0,0,0,0,192,0,0,0,0,0,0,0,0,0,0,0,0,0,0,0,0,0,
0,0,0,0,0,0,216,0,0,0,0,0,0,0,0,0,0,216,0,0,0,0,0,0,
0,0,0,0,0,0,120,0,0,0,0,0,0,0,0,0,0,120,0,0,0,0,0,0,
0,0,0,0,0,167,144,143,0,0,0,0,0,0,0,0,0,144,0,0,0,0,0,0,
0,0,0,0,0,0,168,0,0,0,0,0,0,0,0,0,0,168,0,0,0,0,0,0,
0,0,0,0,0,0,192,0,0,0,0,0,0,0,0,0,0,192,0,0,0,0,0,0,
0,0,0,0,0,0,216,0,0,0,0,0,0,0,0,0,0,216,0,0,0,0,0,0,
0,0,0,0,0,167,120,143,0,0,0,0,0,0,0,0,167,120,143,0,0,0,0,0,
0,0,0,0,0,0,144,0,0,0,0,0,0,0,0,0,0,144,0,0,0,0,0,0,
0,0,0,0,0,0,168,0,0,0,0,0,0,0,0,0,0,168,0,0,0,0,0,0,
0,0,0,0,0,0,192,0,0,0,0,0,0,0,0,0,0,192,0,0,0,0,0,0,
0,0,0,0,0,0,216,0,0,0,0,0,0,0,0,0,167,216,143,0,0,0,0,0,
0,0,0,0,0,0,0,0,0,0,0,0,0,0,0,0,0,0,0,0,0,0,0,0

Position:
0,0,0,0,0,193,193,193,0,0,0,0,0,0,0,0,0,0,0,0,0,0,0,0,
0,0,0,0,0,0,0,0,0,0,0,0,0,0,0,0,0,0,0,0,0,0,0,0,
0,0,0,0,0,0,0,0,0,0,0,0,0,0,0,0,0,0,0,0,0,0,0,0,
0,0,171,0,0,0,0,0,0,0,0,0,170,0,0,0,0,0,0,0,0,0,0,0,
0,0,0,0,0,0,0,0,0,0,0,0,0,0,0,0,0,0,0,0,0,0,0,0,
0,0,0,0,0,0,0,194,0,0,0,0,0,0,0,0,0,0,0,0,0,171,0,0,
0,0,0,0,0,0,0,0,0,0,0,0,0,0,0,0,0,0,0,0,0,0,0,0,
0,0,0,0,0,0,0,0,0,0,0,0,170,0,0,0,0,0,0,0,0,0,0,0,
0,0,0,0,0,0,0,0,0,0,0,0,0,0,0,0,0,0,0,0,0,0,0,0,
0,0,171,0,0,0,0,0,0,0,0,0,0,0,0,0,0,0,0,0,0,0,0,0,
0,0,0,0,0,0,0,0,0,0,0,0,0,0,0,0,0,0,0,0,0,0,0,0,
0,0,0,0,194,0,0,194,0,0,194,0,0,194,0,0,0,0,0,169,0,0,0,0,
0,0,0,0,0,0,0,0,0,0,0,0,0,0,0,0,0,0,0,0,0,0,0,0
