Dimensions{widht,height}:
24,13

BackGround_F:
57,57,57,57,57,57,57,57,57,57,57,57,57,57,57,57,57,57,57,57,57,57,57,57,
57,57,57,57,57,57,57,57,57,57,57,57,57,57,57,57,57,57,57,57,57,57,57,57,
57,57,57,57,57,57,150,151,57,57,57,150,151,57,57,57,150,151,57,57,57,57,57,57,
57,57,57,57,57,57,174,175,57,57,57,174,175,57,57,57,174,175,57,57,57,57,57,57,
57,57,57,57,57,57,198,199,57,57,57,198,199,57,57,57,198,199,57,57,57,57,57,57,
57,57,57,57,57,57,57,57,57,57,57,57,57,57,57,57,57,57,57,57,57,57,57,57,
57,57,57,57,57,57,57,57,57,57,57,57,57,57,57,57,57,57,57,57,57,57,57,57,
57,57,57,109,57,57,57,57,109,110,111,112,113,57,57,57,57,57,57,57,57,57,57,57,
57,57,57,57,57,57,57,57,133,134,135,136,137,57,57,57,57,57,57,57,57,57,57,57,
57,57,57,57,57,57,57,57,157,158,159,160,161,57,57,57,57,57,57,57,57,57,57,57,
57,57,57,57,57,57,57,57,181,182,183,184,185,57,57,57,57,57,57,57,57,57,57,57,
57,57,57,57,57,57,57,57,205,206,207,208,209,57,57,57,57,57,57,57,57,57,57,57,
57,57,57,57,57,57,57,57,57,57,57,57,57,57,57,57,57,57,57,57,57,57,57,57

BackGround_S:
53,49,53,62,0,0,0,0,0,0,0,0,0,0,0,124,125,0,0,0,63,49,53,49,
53,49,53,65,0,0,0,0,0,0,0,0,0,0,0,124,125,0,0,0,63,49,53,49,
53,49,53,0,0,0,0,0,0,0,0,0,0,0,0,148,149,0,0,0,0,49,53,49,
53,49,0,0,0,0,0,0,0,0,0,0,0,0,0,172,173,0,0,0,0,0,53,49,
53,49,0,0,0,0,0,0,0,0,0,0,0,0,0,196,197,0,0,0,0,0,53,49,
53,49,0,0,0,0,0,0,0,0,0,0,0,0,0,0,0,0,0,0,0,0,53,49,
53,49,0,0,9,9,0,0,0,0,0,0,0,0,0,0,0,0,9,9,0,0,53,49,
53,49,0,24,22,24,0,0,0,0,0,0,0,0,0,0,0,0,22,24,22,0,53,49,
53,49,0,9,0,0,0,0,0,0,0,0,0,0,0,0,0,0,0,0,9,0,53,49,
53,49,0,22,24,0,0,0,0,0,0,0,0,0,0,0,0,0,0,22,24,0,53,49,
53,49,0,0,0,0,0,0,0,0,0,0,0,0,0,0,0,0,0,0,0,0,53,49,
53,49,0,24,0,0,0,0,0,0,0,0,0,0,0,0,0,0,0,0,22,0,53,49,
53,49,0,0,0,0,0,0,0,0,0,59,55,0,0,0,0,0,0,0,0,0,53,49

Concrete:
0,0,0,0,0,0,0,0,0,0,0,0,0,0,0,0,0,0,0,0,0,0,0,0,
0,0,0,0,0,0,0,0,0,0,0,0,0,0,0,0,0,0,0,0,0,0,0,0,
0,0,0,0,0,0,0,0,0,0,0,0,0,0,0,0,0,0,0,0,0,0,0,0,
0,0,53,0,0,0,0,0,0,0,0,0,0,0,0,0,0,0,0,0,0,49,0,0,
0,0,53,0,0,0,0,0,0,0,0,0,0,0,0,0,0,0,0,0,0,49,0,0,
0,0,53,0,0,0,0,0,0,0,0,0,0,0,0,0,0,0,0,0,0,49,0,0,
0,0,53,3,0,0,4,0,0,0,0,0,0,0,0,0,0,25,0,0,3,49,0,0,
0,0,53,0,0,0,0,0,0,0,0,0,0,0,0,0,0,0,0,0,0,49,0,0,
0,0,53,0,12,0,0,0,0,0,0,0,0,0,0,0,0,0,0,12,0,49,0,0,
0,0,53,0,0,0,0,0,0,0,0,0,0,0,0,0,0,0,0,0,0,49,0,0,
0,0,53,4,0,0,0,0,0,0,0,0,0,0,0,0,0,0,0,0,25,49,0,0,
0,0,53,0,0,0,0,0,0,0,0,0,0,0,0,0,0,0,0,0,0,49,0,0,
0,0,53,14,14,14,14,14,14,14,14,14,14,14,14,14,14,14,14,14,14,49,0,0

Foregound:
0,0,0,0,0,0,0,0,0,124,125,0,0,0,0,0,0,0,0,0,0,0,0,0,
0,0,0,0,0,0,0,0,0,124,125,0,0,0,0,0,0,0,0,0,0,0,0,0,
0,0,0,0,0,0,0,0,0,124,125,0,0,0,0,0,0,0,0,0,0,0,0,0,
0,0,0,0,0,0,0,0,0,124,125,0,0,0,0,0,0,0,0,0,0,0,0,0,
0,0,0,0,0,0,0,0,0,124,125,0,0,0,0,0,0,0,0,0,0,0,0,0,
0,0,0,0,0,0,0,0,0,148,149,0,0,0,0,0,0,0,0,0,0,0,0,0,
0,0,0,0,0,0,122,0,0,172,173,0,0,0,0,0,0,122,0,0,0,0,0,0,
0,0,0,0,0,0,146,0,0,196,197,0,0,0,0,0,0,146,0,0,0,0,0,0,
0,0,0,0,0,0,0,0,0,0,0,0,0,0,0,0,0,0,0,0,0,0,0,0,
0,0,0,0,0,0,0,0,0,0,0,0,0,0,0,0,0,0,0,0,0,0,0,0,
0,0,0,0,0,0,0,0,0,0,0,0,0,0,0,0,0,0,0,0,0,0,0,0,
0,0,0,0,0,0,0,0,0,0,0,0,0,0,0,0,0,0,0,0,0,0,0,0,
0,0,0,0,0,0,0,0,0,0,0,0,0,0,0,0,0,0,0,0,0,0,0,0

Position:
0,0,0,0,0,0,0,0,0,0,0,0,0,0,0,0,0,0,0,0,0,0,0,0,
0,0,0,0,0,0,0,0,0,0,0,0,0,0,0,0,0,0,0,0,0,0,0,0,
0,0,0,0,0,0,0,0,0,0,0,0,0,0,0,0,0,0,0,0,0,0,0,0,
0,0,0,0,0,0,0,0,0,0,0,0,0,0,0,0,0,0,0,0,0,0,0,0,
0,0,0,0,0,0,0,0,0,0,0,0,0,0,0,0,0,0,0,0,0,0,0,0,
0,0,0,0,0,0,0,0,0,0,0,0,0,0,0,0,0,0,0,0,0,0,0,0,
0,0,0,0,0,0,0,0,0,0,0,0,0,0,0,0,0,0,0,0,0,0,0,0,
0,0,0,0,0,0,0,0,0,0,0,0,0,0,0,0,0,0,0,0,0,0,0,0,
0,0,0,0,0,0,0,0,0,0,0,0,0,0,0,0,0,0,0,0,0,0,0,0,
0,0,0,0,0,0,0,0,0,0,0,0,0,0,0,0,0,195,0,0,0,0,0,0,
0,0,0,0,0,0,0,0,0,0,0,0,0,0,0,0,0,0,0,0,0,0,0,0,
0,0,0,0,0,0,0,0,0,0,169,0,0,0,0,0,0,0,0,0,0,0,0,0,
0,0,0,0,0,0,0,0,0,0,0,0,0,0,0,0,0,0,0,0,0,0,0,0