Dimensions{widht,height}:
24,13

BACKGROUND_F:
51,51,57,57,57,57,57,57,57,57,57,57,57,57,57,57,57,57,57,57,57,57,51,51,
51,51,57,57,57,57,57,57,57,57,57,57,57,57,57,57,57,57,57,57,57,57,51,51,
51,51,57,57,57,57,57,57,57,57,57,57,57,57,57,57,57,57,57,57,57,57,51,51,
51,51,57,57,203,57,57,57,57,57,57,57,57,57,57,57,57,57,57,57,57,57,51,51,
51,51,57,57,57,57,57,57,57,57,57,57,57,57,57,57,57,57,57,57,201,57,51,51,
51,51,57,57,57,57,57,150,151,57,57,57,57,57,57,150,151,57,57,57,57,57,51,51,
51,51,57,57,57,57,57,174,175,57,57,57,57,57,57,174,175,57,57,57,57,57,51,51,
51,51,57,57,57,57,57,198,199,57,57,57,57,57,57,198,199,57,57,57,57,57,51,51,
51,51,57,57,57,57,57,57,57,57,57,57,57,57,57,57,57,57,57,203,57,57,51,51,
51,51,57,57,201,57,57,57,57,57,57,57,57,57,57,57,57,57,57,57,57,57,51,51,
51,51,57,57,57,57,57,57,57,57,57,57,57,57,57,57,57,57,57,57,57,57,51,51,
51,51,57,57,57,57,57,57,57,57,57,57,57,57,57,57,57,57,57,57,57,57,51,51,
51,51,57,57,57,57,57,57,57,57,57,57,57,57,57,57,57,57,57,57,57,57,51,51

BACKGROUND_S:
53,49,0,0,0,0,0,0,0,0,0,59,55,0,0,0,0,0,0,0,0,0,53,49,
53,49,0,24,0,0,0,0,0,0,22,59,55,24,0,0,0,0,0,0,0,0,53,49,
53,0,0,0,0,0,0,0,0,0,0,59,55,0,0,0,0,0,0,0,0,0,53,49,
53,49,0,0,0,0,0,0,0,0,20,59,55,21,0,0,0,0,0,0,22,0,0,49,
53,49,0,0,0,0,0,0,0,0,0,59,55,0,0,0,0,0,0,0,0,0,53,49,
53,49,0,0,0,0,0,0,0,0,22,59,55,24,0,0,0,0,0,0,0,0,53,49,
53,49,0,0,0,0,0,0,0,0,0,59,55,0,0,0,0,0,0,0,0,0,0,49,
53,0,0,24,0,0,0,0,0,0,0,59,55,0,0,0,0,0,0,0,0,0,53,49,
53,49,0,0,0,0,0,0,0,0,0,59,55,0,0,0,0,0,0,0,0,0,0,49,
53,49,0,0,0,0,0,0,0,0,22,59,55,24,0,0,0,0,0,0,0,0,53,49,
53,0,0,0,0,0,0,0,0,0,0,59,55,0,0,0,0,0,0,0,0,49,53,49,
53,49,0,21,0,0,0,0,0,0,20,59,55,21,0,0,0,0,0,0,51,51,53,49,
53,49,0,0,0,0,0,0,0,0,0,59,55,0,0,0,0,0,49,51,51,51,53,49

CONCRETE:
0,0,53,99,99,99,99,99,99,99,99,99,99,99,99,99,99,0,0,0,99,49,0,0,
0,0,53,0,0,0,0,0,0,0,0,0,0,0,0,0,0,0,0,0,0,49,0,0,
0,49,53,0,0,0,0,0,0,0,0,0,0,0,0,0,0,0,25,3,3,49,0,0,
0,0,53,0,0,0,0,0,0,0,0,0,0,0,0,0,0,0,0,0,0,49,53,0,
0,0,53,0,0,0,114,115,116,117,118,0,0,114,115,116,117,118,0,0,0,49,0,0,
0,0,53,0,0,0,0,0,0,0,0,0,0,0,0,0,0,0,0,0,0,49,0,0,
0,0,53,3,3,4,0,0,0,0,0,0,0,0,0,0,0,0,0,0,0,49,53,0,
0,49,53,0,0,0,0,0,0,0,0,0,0,0,0,0,0,0,0,0,0,49,0,0,
0,0,53,0,0,0,0,114,115,116,117,118,114,115,116,117,118,0,0,0,0,49,53,0,
0,0,53,0,0,0,0,0,0,0,0,0,0,0,0,0,0,0,0,0,0,49,0,0,
0,49,53,0,0,0,0,0,0,0,0,0,0,0,0,0,0,0,2,3,3,0,0,0,
0,0,53,0,0,0,0,0,0,0,0,0,0,0,0,0,0,0,49,51,0,0,0,0,
0,0,53,3,44,45,46,3,3,3,3,3,3,3,3,3,3,3,0,0,0,0,0,0

FOREGROUND:
0,0,0,0,0,0,0,0,0,0,0,0,0,0,0,0,0,0,0,0,0,0,0,0,
0,0,0,0,0,0,0,0,0,0,0,0,0,0,0,0,0,0,0,0,0,0,0,0,
0,0,0,0,0,0,0,0,0,0,0,0,0,0,0,0,0,0,0,0,0,0,0,0,
0,0,0,0,0,0,0,0,0,0,0,0,0,0,0,0,0,0,0,0,0,0,0,0,
0,0,0,0,0,0,0,0,0,0,0,0,0,0,0,0,0,0,0,0,0,0,0,0,
0,0,0,0,0,0,0,0,0,0,0,0,0,0,0,0,0,0,0,0,0,0,0,0,
0,0,0,0,0,0,0,0,0,0,0,0,0,0,0,0,0,0,0,0,0,0,0,0,
0,0,0,0,0,0,0,0,0,0,0,0,0,0,0,0,0,0,0,0,0,0,0,0,
0,0,0,0,0,0,0,0,0,0,0,0,0,0,0,0,0,0,0,0,0,0,0,0,
0,0,0,0,0,0,0,0,0,0,0,0,0,0,0,0,0,0,0,0,0,0,0,0,
0,0,0,0,0,0,0,0,0,0,0,0,0,0,0,0,0,0,0,0,0,0,0,0,
0,0,0,0,0,0,0,0,0,0,0,0,0,0,0,0,0,0,0,0,0,0,0,0,
0,0,0,0,0,0,0,0,0,0,0,0,0,0,0,0,0,0,0,0,0,0,0,0

POSITIONS:
0,0,0,0,0,0,0,0,0,0,0,0,0,0,0,0,0,193,193,193,0,0,0,0,
0,0,0,0,0,0,0,0,0,0,0,0,0,0,0,0,0,0,0,0,0,0,0,0,
0,0,171,0,0,0,0,0,0,0,0,0,0,0,0,0,0,0,0,0,0,0,0,0,
0,0,0,0,0,0,0,0,194,0,0,0,0,0,0,170,0,0,0,0,0,171,0,0,
0,0,0,0,0,0,0,0,0,0,0,0,0,0,0,0,0,0,0,0,0,0,0,0,
0,0,0,0,170,0,0,0,0,0,0,0,0,0,0,0,0,0,0,0,0,0,0,0,
0,0,0,0,0,0,0,0,0,0,0,0,0,0,0,0,0,0,0,0,0,171,0,0,
0,0,171,0,0,0,0,0,170,0,0,0,170,0,0,0,0,0,0,0,0,0,0,0,
0,0,0,0,0,0,0,0,0,0,0,0,0,0,0,0,0,0,0,0,0,171,0,0,
0,0,0,0,0,0,0,0,0,0,0,0,0,0,0,0,0,0,0,170,0,0,0,0,
0,0,171,0,0,0,0,0,0,0,0,0,0,0,0,0,0,0,0,0,0,0,0,0,
0,0,0,0,0,169,0,0,0,0,0,194,0,0,0,170,0,0,171,0,0,0,0,0,
0,0,0,0,0,0,0,0,0,0,0,0,0,0,0,0,0,0,0,0,0,0,0,0