Dimensions{widht,height}:
24,13

BackGround_F:
57,57,57,57,57,57,57,57,57,57,57,57,57,57,57,57,57,57,57,57,57,57,57,57,
57,57,57,57,57,57,57,57,57,57,57,57,57,57,57,57,57,57,57,57,57,57,57,57,
57,57,57,57,57,57,57,57,57,57,57,57,57,57,57,57,57,57,57,57,57,57,57,57,
57,57,57,57,57,57,57,57,57,57,57,57,57,57,57,57,57,57,57,57,57,57,57,57,
57,57,57,57,57,150,151,57,57,57,57,57,57,57,57,57,57,150,151,57,57,57,57,57,
57,57,57,57,57,174,175,57,57,57,57,57,57,57,57,57,57,174,175,57,57,57,57,57,
57,57,57,57,57,198,199,57,57,57,57,57,57,57,57,57,57,198,199,57,57,57,57,57,
57,57,57,57,57,57,57,57,57,57,57,57,57,57,57,57,57,57,57,57,57,57,57,57,
57,57,57,57,57,57,57,57,57,57,57,57,57,57,57,57,57,57,57,57,57,57,57,57,
57,57,57,57,57,57,57,57,57,57,57,57,57,57,57,57,57,57,57,57,57,57,57,57,
57,57,57,57,57,57,57,57,57,57,57,57,57,57,57,57,57,57,57,57,57,57,57,57,
57,57,57,57,57,57,57,57,57,57,57,57,57,57,57,57,57,57,57,57,57,57,57,57,
57,57,57,57,57,57,57,57,57,57,57,57,57,57,57,57,57,57,57,57,57,57,57,57

BackGround_S:
53,49,0,0,0,0,0,0,0,99,99,99,99,99,0,0,0,0,0,0,0,0,53,49,
53,49,0,0,0,0,0,0,0,0,0,59,55,0,0,0,0,0,0,0,0,0,53,49,
53,49,0,0,0,0,0,0,0,0,0,59,55,0,0,0,0,0,0,0,0,0,53,49,
53,49,0,0,0,0,0,0,0,0,0,59,55,0,0,0,0,0,0,0,0,0,0,49,
53,49,0,93,0,0,0,90,91,0,0,59,55,0,0,93,94,0,0,90,91,0,53,49,
53,49,0,0,0,0,0,0,0,0,22,59,55,24,0,0,0,0,0,0,0,0,53,49,
53,49,0,0,0,0,0,0,0,0,0,59,55,0,0,0,0,0,0,0,0,0,53,49,
53,0,0,21,0,0,0,0,0,0,20,59,55,21,0,0,0,0,0,0,20,0,53,49,
53,49,0,90,91,92,93,94,90,91,92,93,94,92,93,94,90,91,92,93,94,0,53,49,
53,49,0,24,0,0,0,0,0,0,22,59,55,24,0,0,0,0,0,0,22,0,53,49,
53,49,0,0,0,0,0,0,0,0,0,59,55,0,0,0,0,0,0,0,0,0,53,49,
53,49,0,21,0,0,0,0,0,0,20,59,55,21,0,0,0,0,0,0,20,0,53,49,
53,49,0,0,0,0,0,0,0,0,0,0,0,0,0,0,0,0,0,0,0,0,53,49

Concrete:
0,0,53,99,99,99,99,99,99,0,0,0,0,0,99,99,99,99,0,0,0,49,0,0,
0,0,53,0,0,0,0,0,0,0,0,0,0,0,0,0,0,0,0,0,0,49,0,0,
0,0,53,0,0,0,0,0,0,0,0,0,0,0,0,0,0,0,0,0,0,49,0,0,
0,0,53,0,0,2,4,0,0,0,0,0,0,0,0,0,0,2,4,0,0,49,53,0,
0,0,53,0,118,0,0,0,0,116,117,118,114,115,116,0,0,0,0,0,0,49,0,0,
0,0,53,0,0,0,0,0,0,0,0,0,0,0,0,0,0,0,0,0,0,49,0,0,
0,0,53,12,0,0,0,0,0,0,0,0,0,0,0,0,0,0,0,0,0,49,0,0,
0,49,53,0,0,0,0,0,0,0,0,0,0,0,0,0,0,0,0,0,0,49,0,0,
0,0,53,0,0,2,3,4,0,0,2,3,3,4,0,0,2,3,4,0,0,49,0,0,
0,0,53,0,0,0,0,0,0,0,0,0,0,0,0,0,0,0,0,0,0,49,0,0,
0,0,53,0,0,0,0,0,0,0,0,0,0,0,0,0,0,0,0,0,120,49,0,0,
0,0,53,0,0,0,0,0,0,0,0,0,0,0,0,0,0,0,0,0,144,49,0,0,
0,0,53,3,3,3,3,3,3,3,3,3,3,3,3,3,3,44,45,46,3,49,0,0

Foregound:
0,0,0,0,0,0,0,0,0,0,0,0,0,0,0,0,0,0,0,0,0,0,0,0,
0,0,0,0,0,0,0,0,0,0,0,0,0,0,0,0,0,0,0,0,0,0,0,0,
0,0,0,0,0,0,0,0,0,0,0,0,0,0,0,0,0,0,0,0,0,0,0,0,
0,0,0,0,0,122,122,0,0,0,0,0,0,0,0,0,0,122,122,0,0,0,0,0,
0,0,0,0,0,122,122,0,0,0,0,0,0,0,0,0,0,122,146,0,0,0,0,0,
0,0,0,0,0,122,146,0,0,0,0,0,0,0,0,0,0,146,0,0,0,0,0,0,
0,0,0,0,0,146,0,0,0,0,0,0,0,0,0,0,0,0,0,0,0,0,0,0,
0,0,0,0,0,0,0,0,0,0,0,0,0,0,0,0,0,0,0,0,0,0,0,0,
0,0,0,0,0,0,121,0,0,0,0,0,0,0,0,0,0,121,0,0,0,0,0,0,
0,0,0,0,0,0,121,0,0,0,0,0,0,0,0,0,0,145,0,0,0,0,0,0,
0,0,0,0,0,0,145,0,0,0,0,0,0,0,0,0,0,0,0,0,0,0,0,0,
0,0,0,0,0,0,0,0,0,0,0,0,0,0,0,0,0,0,0,0,0,0,0,0,
0,0,0,0,0,0,0,0,0,0,0,0,0,0,0,0,0,0,0,0,0,0,0,0

Position:
0,0,0,0,0,0,0,0,0,0,0,0,0,0,0,0,0,0,193,193,193,0,0,0,
0,0,0,0,0,0,0,0,0,0,0,0,0,0,0,0,0,0,0,0,0,0,0,0,
0,0,0,0,0,0,194,0,0,0,0,0,0,0,0,0,0,0,0,0,0,0,0,0,
0,0,0,0,0,0,0,0,0,0,0,170,170,0,0,0,0,0,0,0,0,171,0,0,
0,0,0,0,0,0,0,0,0,0,0,0,0,0,0,0,0,0,0,0,0,0,0,0,
0,0,0,0,0,0,0,0,0,0,0,0,0,0,0,0,0,0,0,0,0,171,0,0,
0,0,0,0,0,0,0,0,0,0,0,0,0,0,0,0,0,0,0,0,0,0,0,0,
0,0,171,0,0,0,0,0,0,0,0,170,0,0,0,0,0,0,0,0,0,0,0,0,
0,0,0,0,0,0,0,0,0,0,0,0,0,0,0,0,0,0,0,0,0,0,0,0,
0,0,0,0,0,0,0,0,0,0,0,0,0,0,0,0,0,0,0,0,0,0,0,0,
0,0,171,0,0,0,0,0,0,0,0,0,0,0,0,0,0,0,0,0,0,0,0,0,
0,0,0,0,0,194,0,0,194,0,0,194,0,0,194,0,0,0,169,0,0,0,0,0,
0,0,0,0,0,0,0,0,0,0,0,0,0,0,0,0,0,0,0,0,0,0,0,0