Dimensions{widht,height}:
24,13

BackGround_F:
57,57,57,57,57,57,57,57,57,57,57,57,57,57,57,109,57,203,57,113,57,57,57,57,
57,57,57,57,57,57,150,151,57,57,201,57,57,57,57,57,57,57,57,57,57,57,57,57,
57,57,57,57,57,57,174,175,57,57,57,57,57,57,57,57,57,164,57,57,57,57,57,57,
57,57,57,57,57,57,198,199,57,57,57,57,57,57,57,57,57,57,57,57,57,57,57,57,
57,57,57,57,57,57,57,57,57,57,57,57,57,57,57,57,57,57,57,57,57,57,57,57,
57,57,57,57,57,57,57,57,57,57,57,57,57,57,57,57,57,57,57,57,57,57,57,57,
57,57,57,57,57,57,57,57,57,57,57,57,57,57,57,57,57,57,57,57,57,57,57,57,
57,57,57,57,57,57,57,57,57,57,57,57,57,57,57,57,57,57,57,57,57,57,57,57,
57,57,57,57,57,57,57,57,57,57,57,57,57,57,57,57,57,57,57,57,57,57,57,57,
57,57,57,57,57,57,57,57,57,57,57,57,57,57,57,57,57,57,57,57,57,57,57,57,
57,57,57,57,57,57,57,57,201,57,57,57,57,57,57,57,57,201,57,57,57,57,57,57,
57,57,57,57,57,57,57,57,57,57,57,57,57,57,57,57,57,57,57,57,57,57,57,57,
57,57,57,57,57,57,57,57,57,57,57,57,57,57,57,57,57,57,57,57,57,57,57,57

BackGround_S:
53,49,0,99,99,99,99,99,0,0,0,59,55,0,0,0,0,0,0,0,0,0,53,49,
53,49,0,0,0,0,0,0,0,0,0,59,55,0,0,0,109,110,111,112,113,0,53,49,
53,49,0,0,0,0,0,0,0,0,0,59,55,0,0,0,138,139,140,141,142,0,53,49,
53,49,0,0,0,0,0,0,0,0,0,59,55,0,0,0,162,163,164,165,166,0,53,49,
53,49,0,92,93,94,0,0,92,93,94,0,0,0,0,0,186,187,82,105,190,0,53,49,
53,0,0,24,0,23,24,22,23,0,22,0,0,0,0,0,210,105,105,105,214,0,53,49,
53,49,0,0,0,92,93,94,90,0,0,0,0,0,0,10,10,10,0,0,0,0,53,49,
53,49,0,24,0,23,24,22,23,0,22,0,0,0,22,24,22,0,32,0,0,0,53,49,
53,49,0,92,93,94,0,0,92,93,94,0,0,0,0,22,0,32,0,0,0,0,53,49,
53,49,0,24,0,23,24,22,23,0,22,0,0,0,0,0,32,0,0,0,0,0,53,49,
53,49,0,0,0,47,0,0,47,0,0,0,0,0,0,0,0,0,0,0,0,0,53,49,
53,49,0,0,0,71,0,0,71,0,0,0,0,24,0,0,0,0,0,0,0,0,53,49,
53,49,0,0,0,0,0,0,0,0,0,59,55,0,0,0,0,0,0,0,0,0,53,49

Concrete:
0,0,53,0,0,0,0,0,99,99,99,99,99,99,49,0,0,0,0,0,0,49,0,0,
0,0,53,0,0,0,0,0,0,0,0,0,0,0,49,97,0,0,0,0,0,49,0,0,
0,0,53,0,0,0,0,0,0,0,0,0,0,0,49,0,0,0,0,0,0,49,0,0,
0,0,53,0,0,0,0,0,0,0,53,49,0,0,49,0,0,0,0,0,0,49,0,0,
0,0,53,0,0,0,114,115,0,0,0,53,49,0,49,0,0,0,0,0,0,49,0,0,
0,49,53,0,0,0,0,0,0,0,0,53,49,0,49,0,0,0,0,0,0,49,0,0,
0,0,53,114,115,0,0,0,0,115,116,53,49,0,49,0,0,0,2,3,3,49,0,0,
0,0,53,0,0,0,0,0,0,0,0,53,49,0,0,0,0,2,0,0,0,49,0,0,
0,0,53,0,0,0,114,115,0,0,0,53,49,0,0,0,2,0,0,0,0,49,0,0,
0,0,53,0,0,0,0,0,0,0,0,53,49,0,0,2,0,0,0,0,0,49,0,0,
0,0,53,0,120,0,0,0,0,0,0,53,49,12,0,0,0,0,0,0,0,49,0,0,
0,0,53,0,144,0,0,0,0,0,0,53,49,0,0,0,0,0,0,0,0,49,0,0,
0,0,53,3,3,44,45,46,3,3,3,3,3,3,3,3,3,3,3,3,3,49,0,0

Foregound:
0,0,0,0,0,0,0,0,0,0,0,0,0,0,99,99,99,99,99,99,99,0,0,0,
0,0,0,0,0,0,0,0,0,0,0,0,0,0,0,0,12,122,0,122,12,0,0,0,
0,0,0,0,0,0,0,0,0,0,0,0,0,0,0,0,122,122,0,122,122,0,0,0,
0,0,0,0,0,0,0,0,0,0,0,0,0,0,0,0,122,146,0,146,122,0,0,0,
0,0,0,0,0,0,0,0,0,0,0,0,0,0,0,0,146,0,0,0,146,0,0,0,
0,0,0,0,0,0,0,0,0,0,0,0,0,0,0,0,0,0,0,0,0,0,0,0,
0,0,0,0,0,0,0,0,0,0,0,0,0,0,0,0,0,0,0,0,0,0,0,0,
0,0,0,0,0,0,0,0,0,0,0,0,0,0,0,0,0,0,0,124,125,0,0,0,
0,0,0,0,0,0,0,0,0,0,0,0,0,0,0,0,0,0,0,148,149,0,0,0,
0,0,0,0,0,0,0,0,0,0,0,0,0,0,0,0,0,0,0,172,173,0,0,0,
0,0,0,0,0,0,0,0,0,0,0,0,0,0,0,0,0,0,0,196,197,0,0,0,
0,0,0,0,0,0,0,0,0,0,0,0,0,0,0,0,0,0,0,0,0,0,0,0,
0,0,0,0,0,0,0,0,0,0,0,0,0,0,0,0,0,0,0,0,0,0,0,0

Position:
0,0,0,0,0,0,0,0,0,0,0,0,0,0,0,0,0,0,0,0,0,0,0,0,
0,0,0,0,0,0,0,0,0,0,0,0,0,0,171,0,0,0,0,0,0,0,0,0,
0,0,0,0,0,0,0,0,0,0,0,0,0,0,0,0,0,0,0,0,0,0,0,0,
0,0,0,0,0,0,0,0,0,0,0,0,0,0,0,0,0,0,0,0,0,0,0,0,
0,0,0,0,0,0,0,0,0,0,0,0,0,0,0,0,0,0,193,193,193,0,0,0,
0,0,171,0,0,0,0,0,0,0,0,0,0,0,0,0,0,0,193,193,193,0,0,0,
0,0,0,0,0,0,0,0,0,0,0,0,0,0,0,0,0,0,0,0,0,0,0,0,
0,0,0,0,0,0,0,0,0,0,0,0,0,0,0,0,0,0,0,0,0,0,0,0,
0,0,0,0,0,0,0,0,0,0,0,0,0,0,0,0,0,0,0,0,0,0,0,0,
0,0,0,0,0,0,0,0,0,0,0,171,0,0,0,0,0,0,0,0,0,0,0,0,
0,0,0,0,0,0,0,0,0,0,0,0,0,0,0,0,0,0,0,0,0,0,0,0,
0,0,0,194,0,0,169,0,0,194,194,0,0,0,0,170,0,0,170,0,0,0,0,0,
0,0,0,0,0,0,0,0,0,0,0,0,0,0,0,0,0,0,0,0,0,0,0,0
