Dimensions{widht,height}:
14,12

Background_zero:
57,57,57,57,57,57,57,57,57,57,57,57,57,57,
57,57,57,57,57,57,57,57,57,57,57,57,57,57,
150,151,57,57,57,57,57,57,57,203,57,57,57,57,
174,175,57,57,57,57,57,57,57,57,57,57,57,57,
198,199,57,57,57,57,57,57,57,57,57,57,57,57,
57,57,57,57,201,57,57,57,57,57,57,57,57,57,
57,57,57,57,57,57,57,57,57,57,57,57,57,57,
57,57,203,57,57,57,57,57,57,57,57,57,57,57,
57,57,57,57,57,57,57,57,57,57,57,57,57,57,
57,57,57,57,57,57,57,57,57,57,150,151,57,57,
57,57,57,57,57,57,57,57,57,57,174,175,57,57,
57,57,57,57,57,57,57,57,57,57,198,199,57,57

Background_one:
0,0,0,0,0,0,95,0,0,0,0,0,124,125,
0,0,0,0,0,0,119,0,0,0,0,0,124,125,
0,0,0,0,0,22,23,0,0,0,0,0,124,125,
0,0,0,0,0,0,47,0,0,0,0,0,124,125,
0,0,0,0,0,0,71,24,0,0,0,0,148,149,
0,0,0,0,0,0,95,0,0,0,0,0,172,173,
0,0,0,0,0,22,119,0,0,0,0,0,196,197,
0,0,0,0,0,0,23,0,0,0,0,0,0,0,
0,0,0,0,0,0,47,24,0,0,0,0,0,0,
0,0,0,0,0,0,71,0,0,0,0,0,0,0,
0,0,0,0,0,22,95,0,0,0,0,0,0,0,
0,0,0,0,0,0,119,0,0,0,0,0,0,0

Concrete:
0,0,0,0,0,0,0,0,0,0,0,0,0,0,
0,0,3,3,3,3,0,0,0,0,0,0,0,0,
0,0,0,0,0,0,0,0,0,0,0,0,0,0,
0,0,0,0,0,0,0,3,3,3,3,0,0,0,
0,0,0,0,0,0,0,0,0,0,0,0,0,0,
0,0,3,3,3,3,0,0,0,0,0,0,0,0,
0,0,0,0,0,0,0,0,0,0,0,0,0,0,
0,0,0,0,0,0,0,3,3,3,3,0,0,0,
0,0,0,0,0,0,0,0,0,0,0,0,0,0,
0,0,3,3,3,3,0,0,0,0,0,0,0,0,
0,0,0,0,0,0,0,0,0,0,0,0,0,0,
0,0,0,0,0,0,0,0,0,0,0,0,0,0

Foreground:
0,0,0,0,0,0,0,0,0,0,0,0,0,0,
0,0,0,0,0,0,0,0,0,0,0,0,0,0,
0,0,0,0,0,0,0,0,0,0,0,0,0,0,
0,0,0,0,0,0,0,0,0,0,122,0,0,0,
0,0,0,0,0,0,0,0,0,0,146,0,0,0,
0,0,0,121,0,0,0,0,0,0,0,0,0,0,
0,0,0,145,0,0,0,0,0,0,0,0,0,0,
0,0,0,0,0,0,0,0,123,0,0,0,0,0,
0,0,0,0,0,0,0,0,147,0,0,0,0,0,
0,0,0,0,0,0,0,0,0,0,0,0,0,0,
0,0,0,0,0,0,0,0,0,0,0,0,0,0,
0,0,0,0,0,0,0,0,0,0,0,0,0,0

Positions:
0,0,193,0,170,0,0,0,0,0,0,0,0,0,
0,0,0,0,0,0,0,0,0,0,0,0,0,0,
0,0,0,0,0,0,0,0,170,0,0,0,0,0,
0,0,0,0,0,0,0,0,0,0,0,0,0,0,
0,0,0,0,170,0,0,0,0,0,0,0,0,0,
0,0,0,0,0,0,0,0,0,0,0,0,0,0,
0,0,0,0,0,0,0,0,0,170,0,0,0,0,
0,0,0,0,0,0,0,0,0,0,0,0,0,0,
0,0,0,169,0,0,0,0,0,0,0,0,0,0,
0,0,0,0,0,0,0,0,0,0,0,0,0,0,
0,0,0,0,0,0,0,0,0,0,0,0,0,0,
0,0,0,0,0,0,0,0,0,0,0,0,0,0
